,Month,Product_A,Product_B,Product_C,Total_Sales
0,Jan,150,100,80,330
1,Feb,200,150,130,480
2,Mar,250,200,180,630
3,Apr,300,250,230,780
4,May,400,300,280,980
5,Jun,500,350,330,1180
6,Jul,550,400,380,1330
7,Aug,600,450,430,1480
8,Sep,650,500,480,1630
9,Oct,700,550,530,1780
10,Nov,750,600,580,1930
11,Dec,800,650,630,2080
